* * * * * * * * * * * * * * * * * * * * * * * * * * * * * *
*                                                         *
*                                                         *
*                                                         *
*                                                         *
*                   *     ***  ***  *   *                 *
*                  ***   *  * *   * *   *                 *
*                 * * * *   *   **  **  *                 *
*                 * * * *****     * * * *                 *
*                 * * * *   * *   * * * *                 *
*                  ***  *   *  ***  **  *                 *
*                   *                                     *
*                                                         *
*                   *** *   * *   * *   *                 *
*                  *  * *   * *   * *   *                 *
*                  *  *  *  * ***** **  *                 *
*                  *  *   *** *   * * * *                 *
*                  *  *    *  *   * * * *                 *
*                 *   * ***   *   * **  *                 *
*                                                         *
*                                                         *
*                                                         *
*                         СОНННИК                         *
*                                                         *
*                                                         *
*                                                         *
*                                                         *
*                                                         *
*                                                         *
* * * * * * * * * * * * * * * * * * * * * * * * * * * * * *

                                - 1 -


                              С О Н Н И К


                      Дни от новолуния числимые:

1.  Сон справедливый, изъявляет благополучие.
2.  Сей сон скоро сбудется и при том в радостном приключении.
3.  Не беспокойтесь, сей сон пустой и ничего не значит.
4.  Сей сон не сбудется.
5.  Сей сон в самой точности сбудется.
6.  Этот сон справедлив.
7.  Этот сон не скоро сбудется.
8.  Берегитесь, чтобы чего худого не случилось.
9.  Остерегайтесь худых случаев.
10. Этот сон скоро сбудется.
11. События этого сна надо наблюдать внимательно на 3 день.
12. Этот сон сбудется на 7 день.
13. Что снилося в 10 день совершенно последует.
14. Что снилось, скоро сбудется.
15. Что снилось, весьма скоро скажется.
16. Исполнение этого сна очень скоро последует.
17. Этот сон скоро объявится и на 19 день обязательно сбудется.
18. Это сон исполнится на 20 день.
19. Этот сон справедлив и откроется через 8 дней.
20. Этот сон предвещает благополучие.
21. Этот сон очень точен.
22. Что снилось, ничему не бывать.
23. Хотя снилось, и много, но все пустое.
24. Что снилось, сбудется через 12 дней.
25. Этот сон пустой и ничего не предвещает.
26. Этот сон сбудется в 24 дня.
27. Эти сны не опасны.
28. Хотя и много во сне приснилось, но ничему не бывать.
29. Исполнения этого сна надо ожидать в 24 дня.
30. Этот сон ничего не значит.

                            А

     Алмаз - богатсво, женитьба.
     Арбуз есть - печальное приключение.
     Ассигнация - новости.
     Аэроплан видеть или летать на нем - внезапная перемена жизни.
     Афиша - ложные вести; цветная - смех; черная - печаль.
     Арестованным быть - неожиданность.

                            Б

     Баню видеть, париться - веселье, радость.
     Баранину есть - успехи в предприятии.
     Бить жену - ее неверность; битой быть предвещает худое.
     Блины есть - убыток.
     Богатым быть - болезнь.
     Белых птиц видеть - радостное известие.
     Бал видеть - болезнь, скверное дело.

                                - 2 -

     Баня  -  войти  в  нее  -  безнадежность;  выходить - удовольствие;
видеть  женщину  в  бане  -  огорчение;  мужчину - бедность; танцующих -
болезнь.
     Баран - успех; бадающийся - брань, страх.
     Басом петь - любовь к водке.
     Башмаки надевать - радостный  путь; потерять - препятствие;  чинить
- удовольствие; покупать - улучшение дел в городе.
     Береза - неожиданная радость.
     Беременность - для девушек - обман; для женщины - радость и успех.
     Бить кого-нибудь  - проявлять  справедливость; быть  битым - страх,
ужас.
     Блины есть - неприятность, сплетни.
     Блох ловить - получение денег; кусающих - беда.
     Богоматерь видеть - предстоит самое счастливое событие в жизни.
     Богу молиться - благополучие.
     Больным себя видеть - быть здоровым.
     Бородавки - неприятные известия.
     Босым бегать - бедность.
     Браслет на руке - скандальная история; получить - тайная любовь.
     Бриллианты найти - к взаимной любви.
     Букет  видеть  -  приятное  знакомство;  получать  -  постоянство в
любви.
     Булки есть - полезный для будущего благополучия труд.
     Бумага - письменные работы.

                            В

     Верба в руках - счастье.
     Вино сливать - радость; мутное пить - печаль.
     Вишни есть - не получить обещанного.
     Вода:   чистая -  благополучие; мутная  - печаль;  быстро текущая -
весе  погружаться  в  воду   -  попасть  в  затруднительное   положение;
умываться - радость.
     Волосы видеть:   седыми -  счастье; густыми  - радость;  стричь - к
несчастью.
     Воробья ловить - начало любви и знакомства.
     Ворон кричащий - к наступающей беременности.
     Водку пить - стыд, ошибка.
     Военного видеть - огорчение.
     Войну видеть - ссора.
     Вокзал - дорога.
     Волны - дорога, путешествие.
     Волосы плести в косы - к  радости, к почету; видеть вшей в  волосах
- много денег; чесать - потеря денег.
     Воровать - неудача.
     Восход солнца - хорошие вести или подарки.
     Восковые свечи - печаль; зажигать их - болезнь.
     Вуаль - открытие темных дел.

                            Г

     Гнездо находить - благополучие.
     Говорить ясно - к прибыли.
     Говядину есть - худое приключение.
     Голову   седую   местами   -   печаль;   с   короткими  волосами  -
благополучие.

                                - 3 -

     Горчицу есть - печаль.
     Гостей иметь - ненависть.
     Гром с треском - гнев от начальства; тихий - печаль.
     Голосом сквозь сон петь - к награде.
     Голос приятный - прибыль; сипловатый - убыток.
     Груша - напасть, беда.
     Грязь  -  печаль   или  открытие  тайны;   в  собственном  доме   -
благополучие.
     Гусь - благополучие; потерять - убыток.
     Гадать - не торопись, все будет в свое время.
     Газеты читать - вести издалека.
     Галстук:  надевать -  проигранное дело; развязывать -  освобождение
от скверных дел.
     Гвоздь вбивать - верное решение  будет найдено; найти или видеть  -
счастье; вытаскивать - неудача.
     Генерал - протекция приведет к удаче.
     Гибель корабля:  холостым - скорый брак; женатым - развод.
     Гиря - неподходящий брак.
     Гнилые зубы - ссора.
     Гнезда - женитьба.
     Голого мужчину  видеть -  страх; женщину  - счастье,  честь; себя -
бедствие, несчастье.
     Голодным быть - плохие дела.
     Гора: взбираться - успех; спускаться - неуспех.
     Горб иметь - радость.
     Град - благополучие.
     Гостиница - предстоит дорога.
     Горшок ночной - твои потребности будут удовлетворены.
     Грибы - помощь будет, если обратишься за советом.
     Гробы:  для молодых - свадьба; для семейных - большая прибыль.
     Гроза - благополучие, но и много хлопот.
     Гром - неожиданное и скорое благополучие.
     Груди женские видеть - много счастья и любви, много детей.
     Греться у печи - дороги приведут к успеху.

                            Д

     Дерево - благополучие;  с плодами -  прибыль; без плодов  - убыток;
сухое - обман, измена; рубить  - потеря; сажать - богатство;  цветущее -
успех в делах; срубленное - смерть, траур.
     Дождь - выигрыш; с ветром - несчастье.
     Дорога (идти) - в трудах быть.
     Дыня, тыква - получение дружбы.
     Дама - неприятности, сплетни.
     Дверь не находить - препятствие в делах.
     Двор чистый - радость; грязный - скука.
     Деньги мелкие - печаль;  серебряные - прибыль; бумажные  - новости;
золотые - удовольствие, самолюбие.
     Диких зверей видеть - встреча с врагом.
     Деревня - к счастью.
     Дождь - потеря времени зря.
     Дом строить - к лучшему; мести в доме - гости будут.
     Дорога:   идти  по  ней  -  печаль,  тяжелый труд; кривая - убыток;
железная - спешное дело.

                                - 4 -

     Драку видеть - благополучие;  драться с людьми -  неожиданность, со
зверями - неприятность.
     Дым - опасность.
     Девушка - к лучшему.
     Детей целовать - спокойствие;  грудного видеть - к  благополучию, к
поправке дел; видеть красивых - радость, здравие.

                            Е

     Еврея видеть - хорошие дела.
     Еврейку - благополучие в доме.
     Еж - к неприятности.
     Еловые шишки - неожиданное счастье.
     Еда - удача и прибыль.

                            Ж

     Жаба, лягушка - прельщение.
     Жажду  иметь  и  не  пить  -  худое  окончание дела; пить - успех в
делах.
     Женщину  нагую  видеть  -  вредную  ложь  услышать; простоволосую -
болезнь.
     Жеребенка видеть - независимость.
     Железо - прибыльное дело.
     Жир есть - к свадьбе.

                            З

     Звезды: ясные - радость; неясные - печаль.
     Зеркало: употреблять во сне -  знак женитьбы; жемчужное - к  ссоре;
ржавое - к печали.
     Золото видеть - жалобу иметь; золотую  посуду и из нее пить -  знак
повышения.
     Зубы:   белые  -  к  здоровью;  черные  - быть нелюбимым; чистить -
работа других; выбить - к неуспеху; давать рвать - к болезни;  выпадение
- смерть родственников; языком трогать - успех в делах.
     Забор - препятствие; разрушать - преодолевать препятствие.
     Заблудиться в лесу - злоречие; в городе - трудные дела.
     Завивать волосы - обман.
     Заваривать чай - неожиданность.
     Заикаться - радость.
     Закат солнца - ослабление жизненной силы.
     Замараться - к болезни.
     Заразиться - любовью ответить на любовь.
     Заря - веселье в приятной компании.
     Застрелить кого-нибудь - терпеливо идти к цели; быть  подстреленным
оскорбление.
     Звезда  -  много  счастья,  верная  любовь;  потухающая  -   смерть
родственников, орденская звезда - честь.
     Зелень - надежда.
     Землянику есть - подарки получать.
     Змея - к болезни; раздавить - выздоровление.
     Знамя - радость и почет.

                                - 5 -

                            И

     Играть в карты - ссора; на инструменте - клевета, сплетни.
     Игра - неприятность.
     Игру слышать - новость или радость.
     Измена в браке - опасность огня, пожар.
     Изумруд - веселье.
     Иконы - грядущее искушение будет преодолено.
     Искать  блох  -  обман;  клопов  -  убыток,  вообще  искать  всегда
нехорошо.
     Испугаться - избежать несчастья.

                            К

     Камни дорогие видеть - честь, иногда печаль.
     Кабак, ресторан - беспорядок в доме.
     Каблуки новые - новое занятие; стоптанные - неприятное занятие.
     Кабинет - новая тайна будет разглашена.
     Казарма - трудный общественный подвиг.
     Колбаса - довольствоваться малым.
     Калитка - унижение.
     Корову доить - выигрыш.
     Король - к богатству.
     Кал - получение денег.
     Калоши надевать - осторожность; купить - неприятность.
     Камин с огнем - роскошь.
     Канонада - новости узнать.
     Капусту варить - сплетни; есть - подарок.
     Карлика видеть - задержка в деле.
     Картина - веселое воспоминание.
     Картофель  есть  -   неудовлетворение;  копать  -   неблагоприятная
работа.
     Карусель - провести время беспутно.
     Кататься верхом - радость; на коньках - успешный ход в деле.
     Кашу есть - хлопоты и волнение.
     Кипяток пить - счастье.
     Кисель варить и есть - богатство.
     Китаец - новость узнать.
     Кладбище видеть - счастье; гулять по нему - на верном пути к нему.
     Книги читать - учиться; рвать - забывать что-то важное.
     Колосья видеть - исполнение желания.
     Кошка - слезы; котята - неожиданность.
     Красть - убыток, слезы; быть обкраденным - свадьба.
     Кровь - нечаянность.
     Кровать пустая - смерть знакомого.
     Крылья иметь - благополучие.
     Крысы - горе и слезы.
     Кудри чесать - радость и увлечение.
     Купаться - хлопоты.
     Куры - деньги.
     Кухня: чистая - прибыль; грязная - беспорядок.

                            Л

     Ласточка - выигрыш.
     Лестниц много и по ним ходить - помешательство ума.

                                - 6 -

     Летать низко - к дороге.
     Лицо:   красное  -  горе;  запачконное  -  к  облегчению; бледное -
радость видеть в зеркале  - прибыль или рождение  сына; в воде мыть  - к
долголетию.
     Ложе или постель - к женитьбе или прибыли.
     Лев - иметь беспокойство; много львов - свидание с важной особой.
     Лакей - неудача.
     Лапти - бедность.
     Ласкать кого-нибудь - радость.
     Лай слышать - радость или новость.
     Лгать - быть наказанным.
     Лебедь:  одиноко плывуший - разлука; пара - семейное счастье.
     Луна светлая - сватовство или приятная неожиданность.
     Лодка:   плавать  на  ней  -  успокоение  страстей,  опрокинуться -
несчастье.
     Лошадь - устройство дел; слезать с лошади - потеря положения.
     Лук чистить - успех в трудном предприятии.
     Лыжи (сам на лыжах) - удовольствие.
     Люди наглые - злословие и стыд.

                            М

     Масло всякое - получение милости.
     Мать видеть - благополучие.
     Мглу: густую - болезнь; редкую - благополучие.
     Мертвого видеть - опасная болезнь.
     Медаль - препятствие.
     Младенца - труд.
     Молоко - радость.
     Монета - бедность, досада.
     Морковь есть - болезнь.
     Море волнующееся  - печаль,  убыток; плавать  по морю  - богатство,
сила.
     Муку ржаную: богатым - счастье; бедным - болезнь.
     Муравьи - почесть; бегущие в дом - смерть злодеев.
     Мухи - печаль, хлопоты.
     Мыться - богатство, здоровье; в платье - болезнь, вред.
     Малину есть - счастье и наслаждение в кругу молодежи.
     Медведь - дружба.
     Милостыню просить и получать - богатство.
     Могилу капать по собственной вине - счастье терять.
     Молодым быть - улучшение здоровья.
     Молоток - назойливость родных.
     Морковь - к выгоде.
     Мороз чувствовать - улучшенным быть.
     Мост переходить - избежать опасности.
     Музыку слышать - интересный разговор.
     Мыло - неожиданность.
     Мыши - потеря денег.
     Мех - уютная и богатая жизнь.

                            Н

     Навозная куча - изобилие, богатство, благополучие.
     Находку иметь - добрая надежда.

                                - 7 -

     Небо:   красное  -  ссора;  голубое  -  радость;  ясное  -  большой
выигрыш; звездное - исполнение желаний; возноситься - успех в делах.
     Непогода - опасность, несчастье.
     Ноги обмывать - путешествие.
     Ногти:   длинные  -  обманутые  надежды;  короткие  - торопливость;
грязные - досада; грызть - иметь обиду.
     Нос:   большой -  премудрость и  милость; малый  - ущерб; утирать -
свобода от хлопот.
     Напиться допьяна - болезнь.
     Наряжаться - к счастью.
     Ножницы - к разладу в семье.
     Ноздри видеть - гнев и сладострастие.
     Номера и числа видеть - запомни их, они принесут тебе счастье.
     Носки - к горю.

                            О

     Обезьяна - иметь врага.
     Одежду:   потерять  -  стыд;  одеваться  в  новое  платье - печаль;
одетым быть в длинное платье - награда.
     Обливать или обливаться - брать в долг.
     Овес - переменчивое счастье.
     Овцы - счастье и здоровье.
     Овощи есть - скудная жизнь.
     Огонь - несбыточная мечта; горящий  дом - большая радость; огонь  и
дым - опасность грозит.
     Одежда: чистая - слава,  честь; замаранная - бесчестье;  потерять -
стыд; полуодетым быть - признание трех достоинств.
     Одеяло - набраться храбрости.
     Ожерелье - хорошее положение.
     Озеро - пир, путь.
     Орел - успех.
     Осел - оскорбительное известие.
     Отхожее место - неприятности; упасть в него - получить деньги.
     Офицер - честь.
     Очки - недоверчивость друга.
     Орехи - выигрыш с трудом; грецкие - печаль; лесные - слезы.

                            П

     Паук - упущенное дело.
     Перец - несчастье.
     Перчатки надевать - всеобщее благополучие.
     Печка  -  домашним  счастьем  довольствоваться;  огонь  в  печке  -
богатство.
     Пить хотеть - иметь хлопоты.
     Пожар - радость.
     Помидор - тайная любовь.
     Падать   -   оскорбление;   падать   и   удержаться  -  возвращение
потерянного.
     Переплыть реку - исполнение намеченного.
     Перстень:   потерять  -  надежду  утратить;  давать или принимать -
благополучие; на руках - получение почестей.
     Пиво пить - радость.
     Пироги есть - благополучие.

                                - 8 -

     Пить из рюмки - смерть.
     Плевать - убыток.
     Платье золотое  - зависть;  запачканное -  неблагополучие; новое  -
богатство; рогожное - досада; дырявое - беда.
     Плоды есть: сладкие - богатство; кислые - болезнь.
     Погребение - женитьба.
     Полотно белое - ложь, клевета.
     Прорубь - беда.
     Пруд видеть и в нем купаться - хлопоты.
     Пса (собаку) - прибыль; лающего - вред.
     Пьяным быть - стыд, убыток.

                            Р

     Розы - к любви и счастью.
     Река - дорога.
     Рвать цветы - пользоваться удовольствием жизни.
     Ребят маленьких - труд.
     Радугу: в восточной стороне неба  - перемена счастья; в западной  -
несчастье.
     Раки - благополучный отъезд.
     Реку переходить - приятное угощение.
     Рога иметь - отчаянная жизнь.
     Родителей  умерших  -  благополучие;  отчима  или  мачеху - досада,
скука.
     Рубаху белую одеть - хорошая примета, надежда.
     Рыб:  множество - большая  прибыль; больших рыб - клевета;  вареную
рыбу есть - убыток.

                            С

     Сад (прогуливаться) - успех в делах.
     Сватья - душевная печаль.
     Свет видеть - к радости.
     Снег - к плодородию.
     Собака - верный друг, укус  собаки - предательство друга; манить  -
разговор с приятелем; собачьи ласки - тайны, неприятельский умысел.
     Сова - одинокая жизнь, философские мысли
     сад зеленый, цветущий - радость.
     Свеча - любовь; горящая тускло - опасность.
     Сад зеленый, цветущий - радость.
     Стекло видеть - обман.
     Сыр есть: кислый - обман; свежий - выигрыш.

                            Т

     Трава зеленая - здоровье.
     Туман над водой - благополучие.
     Тело свое  больше обыкновенного  видеть -  повышение чина;  нагим -
стыд; толстым - прибыль.
     Тюрьма - болезнь.

                                - 9 -

                            У

     Удить рыбу - печаль.
     Угря видеть - труд и новая должность.
     Умершего воскресшим видеть - знак благополучия.
     Уши:  большими видеть  - болезнь; пригожими -  похвала; нескладными
- безумие.

                            Ц

     Цветы - удовольствие.

                            Ч

     Чучело - странное приключение.

                            Ш

     Штаны одеть - убыток.
     Шляпа на голове - честь и возвращение убытка.

                            Щ

     Щенок - неожиданный друг.
     Щипать - оклеветанным быть.
     Щель - недостаток в жизни.

                            Э

     Экзамен - успех после долгих волнений.

                            Я

     Яблоки:  зрелые - благополучная женитьба; горькие - беда;  незрелые
- вред; печеные  - корысть; вкусные  - благополучие; сладкие  - веселье;
винные -  радость; белые  - успех;  красные -  слезы; сушеные, вареные -
корысть.
     Ящерица - предвещает врага; убить - победа; есть - обогашение;
