                    Словариада


Гуляш - любитель застолья
Головомойка - шампунь
Автомат - самокритика
Наставить рога - выдать свинину за говядину
Набить руку - взятка
Брачный союз - дружба бракоделов
Барсук - кормушка для собак
Совращение - вальс
Присутствие духа - спиритизм
Любитель острых ощущений - шпагоглотатель
Милости просим - последнее слово подсудимых
Ты мне, я тебе - бокс
Парень хоть куда - курьер
Одаренный человек - юбиляр
Бездарность - гость без подарка
Пиковая дама - альпинистка
Даром не пройдет - девиз билетерши
Сон в руку - инъекция снотворного
Тянуть жилы - настраивать гитару
Мерзавец - холодильник
Заводила - стартер
Выкуп - баня
Забегаловка - кросс
Свинец - кабан
Главбух - маршал артиллерии
Гашиш - гектар, на котором ничего не выросло
Неряха - тонкое лицо
Колики - фехтование
Приставала - клей
Парник - близнец
Сотник - пасечник
Грабли - воры
Закройщик - швейцар
Капельмейстер - самогонщик
Купе - сауна
Литейщик - бармен
Рубль - дровосек
Стихия - поэтесса
Стриж - парикмахер
Туша - пожарник
Знать как облупленного  --  познакомиться на пляже
Подвести базу  --  не разгрузить вагон с кар8тош8кой
Спорить с пеной у рта  --  беседовать в пивном баре
Брать с боем  --  покупать яйца по сниженной цене
Совращение  --  вальс
Весельчак  --  гребец
Скверный  --  бульварный
Сопение  --  дуэт
Перешеек  --  гильотина
Компромисс  --  скомпрометированная девушка
Досада  --  ясли
Всадник  --  дошкольник
Ельник  --  рот
Жар-птица  --  ципленок табака
Заколка  --  шпага
Изверг  --  вулкан
Курзал  --  птицеферма
Лицемер  --  антрополог
Микропорка  --  маленькая взбучка
еваляшка  --  трезвеница
Пеленг  --  новорожденный
Всенощная  --  преферанс
Высокородие  --  демографический взрыв
Доминировать  --  забивать козла
Сократ  --  уволенный по сокращению
Фаустпатрон  --  Мефистофель
Холостой патрон  --  неженатый шеф
Бакалавр  --  продавец в бакалейной лавке
Пломбир  --  зубной врач
Обвести вокруг пальца  --  надеть обручальное кольцо
Заложить за воротник  --  воспользоваться салфеткой
