                          Постреволюционные имена


                Как вы лодку назовёте, так она и поплывет.

                               (капитан Врунгель)


   Нет! Даже не надейтесь! Я не Борис Хигир, а потому тайну Вашего имени
раскрывать не буду... Хотя можно было пройтись по какому-нибудь словарю
необходимых познаний, привести здесь кучу всяких трактовок современных
имен... но зачем? во-первых, все они сюда всё равно не войдут, во-вторых,
таких трактователей уже пруд пруди... нет, надо что-то оригинальное! а вот
что?!
   В свое время я увлекся такой темой, как "постреволюционные имена"
(Господи, придумал же я название) - или, проще, составные шуточные имена,
которые появлялись в нашей стране после революции семнадцатого года и
вплоть до настоящих времён (не удивлятесь, об этом я тоже расскажу, и Вы
поймете)... всем прекрасно известно имя Даздраперма ("Да здравствует Первое
мая!") - но ведь подобных опусов немало! Кстати, здесь я даже не буду
вспоминать имена, которые широко использовались тогда: Искра, Революция,
Олимпиада (это, понятно, немного позже), Владлен (не удивлятесь, это тоже
сокращение от Владимира Ленина)... вспомним только некоторые из особо
"мудрых".

  Итак,

Арвиль - "АРмия В.И.Ленина"

Артака - "АРТиллерийская АКАдемия"

Ватерпежекосма - "ВАлентина ТЕРешкова - ПЕРвая ЖЕнщина-КОСМонавт"

Вектор - "ВЕликий Коммунизм ТОРжествует"

Велиор - "ВЕЛИкая Октябрьская Революция"

Велира - "ВЕЛИкий РАбочий"

Веор - "ВЕликая Октябрьская Революция"

Видлен - "Великии ИДеи ЛЕНина"

Вилан - "В.И.Ленин и Академия Наук"

Вилен - "В.И.ЛЕНин"

Вилор(а) - "В.И.Ленин - Организатор Революции"

Вилорик - "В.И.Ленин - Освободитель Рабочих И Крестьян"

Вилюр - "В.И.Ленин ЛЮбит Родину"

Винун - "Владимир Ильич Не Умрет Никогда"

Вист - "Великая Историческая Сила Труда"

Владлен - "ВЛАДимир ЛЕНин"

Волен - "ВОля ЛЕНина"

Ворс - "ВОРошиловский Стрелок"

Гертруда - "ГЕРой ТРУДА"

Дазвсемир - "ДА Здравствует ВСЕМИрная Революция"

Даздраперма - "ДА ЗДРАвствует ПЕРвое МАя!"

Далис - "ДА здравствуют Ленин И Сталин"

Дележ - "ДЕло ЛЕнина Живет"

Динэр(а) - "ДИтя Новой ЭРы"

Донэра - "ДОчь Новой ЭРы"

Дотнара - "ДОчь Трудового НАРода"

Идлен - "ИДеи ЛЕНина"

Изиль - "Исполняй Заветы ИЛЬича"

Истмат - "ИСТорический МАТериализм"

Кид - "Коммунистический ИДеал"

Ким - "Коммунистический Интернационал Молодежи"

Крармия - "КРасная АРМИЯ"

Кукуцаполь - "КУКУруза - ЦАрица ПОЛей"

Лагшмивара - "ЛАГерь ШМИдта В АРктике"

Ласт - "ЛАтышский СТрелок"

Ледат - "ЛЕв ДАвидович Троцкий"

Ледруд - "ЛЕнин - ДРУг Детей"

Лелюд - "ЛЕнин ЛЮбит Детей"

Ленар(а) - "ЛЕНинская АРмия"

Ленгенмир - "ЛЕНин - ГЕНий МИРа"

Ленинид - "ЛЕНИНские ИДеи"

Ленинир - "ЛЕНИН И Революция"

Лениор - "ЛЕНин И Октябрьская Революция"

Ленора - "ЛЕнин - Наше ОРужие"

Лента - "ЛЕНинская Трудовая Армия"

Лентрош - "ЛЕНин, ТРОцкий, Шаумян"

Лес - "ЛЕнин, Сталин"

Лестак - "ЛЕнин, СТАлин, Коммунизм"

Лориэрик - "Ленин, Октябрьская Революция, Индустриализация, Электрификация, Радиофикация И Коммунизм"

Леундеж - "ЛЕнин Умер, Но Дело Его Живет"

Лунио - "Ленин Умер, Но Идеи Остались"

Луиджи(а) - "Ленин Умер, но ИДеи ЖИвы"

Люблен - "ЛЮБи ЛЕНина"

Марлен - "МАРкс, ЛЕНин"

Маэлс - МАркс, Энгельс, Ленин, Сталин

Маэнлест - МАркс, ЭНгельс, ЛЕнин, СТалин

Мэлор - Маркс, Энгельс, Ленин, Октябрьская Революция

Мюнд - Международный ЮНошеский День

Нинель - "Ленин (задом наперед)"

Нисерха - "НИкита СЕРгей Хрущев"

Одвар - "Особая ДальнеВосточная АРмия"

Орлетос - "Октябрьская Революция, ЛЕнин, Труд - Основа Социализма"

Оюшминальда - "О.Ю.ШМИдт НА ЛЬДине"

Папир - "ПАртийная ПИРамида"

Персострат - "ПЕРвый СОветский СТРАТостат"

Пол(ь)за - "ПОмни Ленинские ЗАветы"

Порес - "ПОмни РЕшение Съездов"

Пофистал - "ПОбедитель Фашизма Иосиф СТАЛин"

Правлен - "ПРАВда ЛЕНина"

Придеспар - "ПРИвет ДЕлегата Съезда ПАРтии"

Пятвчет - "ПЯТилетку В ЧЕТыре года!"

Райтия - "РАЙонная ТИпографиЯ"

Ревмарк - "РЕВолюционный МАРКсизм"

Ревмира - "РЕВолюция МИРА"

Рем - "РЕволюция Мировая"

Рим - "Революция И Мир"

Рэм - "Революция, Энгельс, Маркс"

Роблен - "РОдился Быть ЛЕНинцем"

Силен - "СИла ЛЕНина"

Стален - "СТАлин+ЛЕНин"

Статор - "СТАлин ТОРжествует"

Таклис - "ТАКтика Ленина И Сталина"

Томил - "ТОржество Маркса И Ленина"

Томик - "ТОржествует Марксизм И Коммунизм"

Тролен - "ТРОцкий, ЛЕНин"

Урюрвкос - "УРа, ЮРа В КОСмосе!"

Челнальдин(а) - "ЧЕЛюскин НА ЛЬДИНе"

Эрлен - "ЭРа ЛЕНина"

Ясленик - "Я С ЛЕНиным И Крупской"
